XXXXXXXXXX
XXX X    X
X     X  X
XPX X E  X
XXXXXXXXXX